XXXXXXXXXXXXXXX
XXXX        X X
X      XXXX XXX
XXXXXX G     SX
XXXXXXXXXXXXXXX